District,Municipality,Administrative Unit,PS,PD,Other Parties,Invalid Ballots,Eligible Voters,Total Eligible Votes,Total Votes,Turnout
Berat,Berat,Berat,11312,7214,2255,1159,52154,20781,21940,30214
Berat,Berat,Otllak,2673,1726,638,347,12029,5037,5384,6645
Berat,Berat,Roshnik,830,311,84,114,2857,1225,1339,1518
Berat,Berat,Sinje,1041,516,253,165,3908,1810,1975,1933
Berat,Berat,Velabisht,2446,1100,525,413,9397,4071,4484,4913
Berat,Kucove,Kozare,1441,1198,275,222,6465,2914,3136,3329
Berat,Kucove,Kucove,4728,2517,900,449,24378,8145,8594,15784
Berat,Kucove,Lumas,1145,641,213,118,5372,1999,2117,3255
Berat,Kucove,Perondi,2085,1002,576,263,8688,3663,3926,4762
Berat,Polican,Polican,1720,344,591,151,6179,2655,2806,3373
Berat,Polican,Terpan,449,107,144,46,1692,700,746,946
Berat,Polican,Vertop,1702,594,217,160,5309,2513,2673,2636
Berat,Skrapar,Bogove,201,119,149,39,1237,469,508,729
Berat,Skrapar,Cepan,157,45,174,19,758,376,395,363
Berat,Skrapar,Corovode,1281,282,889,152,4701,2452,2604,2097
Berat,Skrapar,Gjerbes,186,65,83,25,814,334,359,455
Berat,Skrapar,Leshnje,172,20,96,11,516,288,299,217
Berat,Skrapar,Potom,358,26,101,18,793,485,503,290
Berat,Skrapar,Qender-Skrapar,780,165,526,110,3096,1471,1581,1515
Berat,Skrapar,Vendresh,262,38,187,29,939,487,516,423
Berat,Skrapar,Zhepe,150,16,102,24,720,268,292,428
Berat,Ura Vajgurore,Cukalat,703,634,112,139,3237,1449,1588,1649
Berat,Ura Vajgurore,Kutalli,2478,1738,483,441,10339,4699,5140,5199
Berat,Ura Vajgurore,Poshnje,1812,1446,332,322,8220,3590,3912,4308
Berat,Ura Vajgurore,Ura Vajgurore,2243,1174,339,356,9321,3756,4112,5209
Diber,Bulqize,Bulqize,1861,1439,1051,476,9158,4351,4827,4331
Diber,Bulqize,Fushe Bulqize,605,528,405,193,2992,1538,1731,1261
Diber,Bulqize,Gjorice,839,756,138,160,3946,1733,1893,2053
Diber,Bulqize,Martanesh,420,205,91,63,1660,716,779,881
Diber,Bulqize,Ostren,604,572,55,89,2371,1231,1320,1051
Diber,Bulqize,Shupenze,1154,936,259,187,5019,2349,2536,2483
Diber,Bulqize,Trebisht,261,123,13,13,772,397,410,362
Diber,Bulqize,Zerqan,679,819,233,181,3667,1731,1912,1755
Diber,Diber,Arras,508,629,77,55,2539,1214,1269,1270
Diber,Diber,Fushe Cidhen,307,655,151,85,2590,1113,1198,1392
Diber,Diber,Fushe Muhur,448,484,155,76,2427,1087,1163,1264
Diber,Diber,Kala e Dodes,198,357,20,16,1695,575,591,1104
Diber,Diber,Kastriot,1028,1242,436,225,5466,2706,2931,2535
Diber,Diber,Lure,158,282,13,37,898,453,490,408
Diber,Diber,Luzni,390,532,72,91,2046,994,1085,961
Diber,Diber,Maqellare,2185,2103,524,297,10269,4812,5109,5160
Diber,Diber,Melan,682,822,120,105,3166,1624,1729,1437
Diber,Diber,Peshkopi,3154,3814,801,495,14539,7769,8264,6275
Diber,Diber,Selishte,223,284,47,20,1174,554,574,600
Diber,Diber,Sllove,520,525,74,58,2109,1119,1177,932
Diber,Diber,Tomin,1293,1700,318,239,6294,3311,3550,2744
Diber,Diber,Zall Dardhe,195,178,22,8,786,395,403,383
Diber,Diber,Zall Rec,170,140,15,7,624,325,332,292
Diber,Klos,Gurre,654,851,78,99,2902,1583,1682,1220
Diber,Klos,Klos (DI),1889,1771,310,368,7911,3970,4338,3573
Diber,Klos,Suc,569,623,60,100,2571,1252,1352,1219
Diber,Klos,Xiber,590,493,64,77,2218,1147,1224,994
Diber,Mat,Baz,446,605,117,58,2327,1168,1226,1101
Diber,Mat,Burrel,3478,2438,483,323,13354,6399,6722,6632
Diber,Mat,Derjan,217,226,35,41,992,478,519,473
Diber,Mat,Komsi,922,906,93,149,3933,1921,2070,1863
Diber,Mat,Lis,962,706,61,143,3606,1729,1872,1734
Diber,Mat,Macukull,258,350,11,40,1284,619,659,625
Diber,Mat,Rukaj,499,649,69,81,2517,1217,1298,1219
Diber,Mat,Ulez,376,277,64,31,1403,717,748,655
Durres,Durres,Ishem,1350,1029,274,146,6878,2653,2799,4079
Durres,Durres,Katund I Ri,1875,2878,256,276,12392,5009,5285,7107
Durres,Durres,Manez,1976,1640,277,221,9218,3893,4114,5104
Durres,Durres,Rrashbull,5946,4846,1226,602,26614,12018,12620,13994
Durres,Durres,Sukth,3650,3791,871,594,22209,8312,8906,13303
Durres,Durres,Durres,37512,29322,5623,3268,181322,72457,75725,105597
Durres,Kruje,Bubq,1672,1227,288,165,6875,3187,3352,3523
Durres,Kruje,Cudhi,739,494,80,68,2164,1313,1381,783
Durres,Kruje,Fushe Kruje,5354,4463,1057,567,20713,10874,11441,9272
Durres,Kruje,Koder Thumane,3298,2506,307,326,12766,6111,6437,6329
Durres,Kruje,Kruje,2559,3382,1099,402,12941,7040,7442,5499
Durres,Kruje,Nikel,3008,2004,221,311,8278,5233,5544,2734
Durres,Shijak,Gjepalaj,987,835,306,93,4653,2128,2221,2432
Durres,Shijak,Maminas,1490,707,153,179,6039,2350,2529,3510
Durres,Shijak,Shijak,2689,1529,281,226,10768,4499,4725,6043
Durres,Shijak,Xhafzotaj,2819,2778,389,364,14900,5986,6350,8550
Elbasan,Belsh,Belsh,2480,1912,201,305,11638,4593,4898,6740
Elbasan,Belsh,Fierze (EL),608,517,46,83,3148,1171,1254,1894
Elbasan,Belsh,Grekan,950,483,65,127,3909,1498,1625,2284
Elbasan,Belsh,Kajan,1128,764,58,137,5085,1950,2087,2998
Elbasan,Belsh,Rrase,386,270,22,40,1833,678,718,1115
Elbasan,Cerrik,Cerrik,2693,1213,300,228,11940,4206,4434,7506
Elbasan,Cerrik,Gostime,2165,1192,564,235,10219,3921,4156,6063
Elbasan,Cerrik,Klos (EL),742,548,213,94,3455,1503,1597,1858
Elbasan,Cerrik,Mollas (EL),1764,604,251,170,6027,2619,2789,3238
Elbasan,Cerrik,Shales,983,670,224,120,5566,1877,1997,3569
Elbasan,Elbasan,Bradashesh,2965,2134,351,488,10707,5450,5938,4769
Elbasan,Elbasan,Funare,737,417,45,86,2157,1199,1285,872
Elbasan,Elbasan,Gjergjan,1595,716,210,184,6342,2521,2705,3637
Elbasan,Elbasan,Gjinar,1052,451,191,101,3521,1694,1795,1726
Elbasan,Elbasan,Gracen,560,294,84,61,1689,938,999,690
Elbasan,Elbasan,Labinot Fushe,1343,1569,151,226,5265,3063,3289,1976
Elbasan,Elbasan,Labinot Mal,1432,997,107,218,4110,2536,2754,1356
Elbasan,Elbasan,Paper,1701,1261,208,212,7237,3170,3382,3855
Elbasan,Elbasan,Shirgjan,2107,1300,195,257,8316,3602,3859,4457
Elbasan,Elbasan,Shushice,2324,1504,280,361,8673,4108,4469,4204
Elbasan,Elbasan,Tregan,935,719,115,119,3440,1769,1888,1552
Elbasan,Elbasan,Zavaline,441,200,39,22,1370,680,702,668
Elbasan,Elbasan,Elbasan,23617,19733,3164,2313,105852,46514,48827,57025
Elbasan,Gramsh,Gramsh,3056,1585,459,248,10721,5100,5348,5373
Elbasan,Gramsh,Kodovjat,746,343,141,90,2321,1230,1320,1001
Elbasan,Gramsh,Kukur,600,293,149,94,2110,1042,1136,974
Elbasan,Gramsh,Kushove,286,143,30,23,840,459,482,358
Elbasan,Gramsh,Lenie,239,100,37,28,761,376,404,357
Elbasan,Gramsh,Pishaj,1694,824,183,146,5269,2701,2847,2422
Elbasan,Gramsh,Porocan,396,130,37,94,1166,563,657,509
Elbasan,Gramsh,Skenderbegas,366,219,79,35,1349,664,699,650
Elbasan,Gramsh,Sult,280,144,34,21,931,458,479,452
Elbasan,Gramsh,Tunje,454,202,89,45,1562,745,790,772
Elbasan,Librazhd,Hotolisht,1635,763,274,253,5230,2672,2925,2305
Elbasan,Librazhd,Librazhd,2497,1604,368,216,8602,4469,4685,3917
Elbasan,Librazhd,Lunik,737,338,50,99,2568,1125,1224,1344
Elbasan,Librazhd,Orenje,1170,484,78,162,3493,1732,1894,1599
Elbasan,Librazhd,Polis,1211,475,82,108,3936,1768,1876,2060
Elbasan,Librazhd,Qender-Librazhd,2509,1324,371,379,8411,4204,4583,3828
Elbasan,Librazhd,Stebleve,193,193,6,26,828,392,418,410
Elbasan,Peqin,Gjocaj,1094,1128,77,192,5745,2299,2491,3254
Elbasan,Peqin,Karine,452,260,10,32,1492,722,754,738
Elbasan,Peqin,Pajove,1642,1251,72,180,7042,2965,3145,3897
Elbasan,Peqin,Peqin,1790,1413,200,163,7212,3403,3566,3646
Elbasan,Peqin,Perparim,857,741,125,67,4305,1723,1790,2515
Elbasan,Peqin,Sheze,868,604,31,67,4386,1503,1570,2816
Elbasan,Prrenjas,Prrenjas,1723,983,645,205,6912,3351,3556,3356
Elbasan,Prrenjas,Qukes,2225,1369,415,233,7963,4009,4242,3721
Elbasan,Prrenjas,Rajce,2134,1073,881,293,8219,4088,4381,3838
Elbasan,Prrenjas,Stravaj,662,424,49,85,2075,1135,1220,855
Fier,Divjake,Divjake,2363,2298,543,368,11531,5204,5572,5959
Fier,Divjake,Grabian,1025,863,129,152,4922,2017,2169,2753
Fier,Divjake,Gradisht,2496,1374,411,234,8691,4281,4515,4176
Fier,Divjake,Remas,1192,1026,211,143,5203,2429,2572,2631
Fier,Divjake,Terbuf,2638,1876,446,374,12607,4960,5334,7273
Fier,Fier,Cakran,3123,2290,487,321,12759,5900,6221,6538
Fier,Fier,Frakull,2132,1299,337,222,8331,3768,3990,4341
Fier,Fier,Levan,2350,1705,482,315,14046,4537,4852,9194
Fier,Fier,Portez,2186,1328,457,215,9129,3971,4186,4943
Fier,Fier,Dermenas,1929,1764,513,227,10216,4206,4433,5783
Fier,Fier,Libofshe,1907,935,337,185,8317,3179,3364,4953
Fier,Fier,Mbrostar,1788,1320,842,292,8429,3950,4242,4187
Fier,Fier,Qender-Fier,1953,1549,469,264,9954,3971,4235,5719
Fier,Fier,Topoje,1763,471,207,129,6132,2441,2570,3562
Fier,Fier,Fier,17507,11933,3521,1057,77732,32961,34018,43714
Fier,Lushnje,Allkaj,1356,739,370,159,5039,2465,2624,2415
Fier,Lushnje,Ballagat,606,515,45,121,2970,1166,1287,1683
Fier,Lushnje,Bubullime,1979,933,320,217,5845,3232,3449,2396
Fier,Lushnje,Dushk,1768,1415,364,221,9413,3547,3768,5645
Fier,Lushnje,Fier Shegan,1778,1225,637,276,7656,3640,3916,3740
Fier,Lushnje,Golem (FR),1253,858,268,189,6084,2379,2568,3516
Fier,Lushnje,Hysgjokaj,597,610,95,90,2771,1302,1392,1379
Fier,Lushnje,Karbunare,1148,654,155,171,4406,1957,2128,2278
Fier,Lushnje,Kolonje,1896,1148,283,180,6697,3327,3507,3190
Fier,Lushnje,Krutje,2666,1267,423,246,8292,4356,4602,3690
Fier,Lushnje,Lushnje,9747,7705,1338,908,45076,18790,19698,25378
Fier,Mallakaster,Aranitas,643,551,122,96,3059,1316,1412,1647
Fier,Mallakaster,Ballsh,1699,1596,537,181,8722,3832,4013,4709
Fier,Mallakaster,Fratar,933,555,177,120,3819,1665,1785,2034
Fier,Mallakaster,Greshice,293,144,122,41,1465,559,600,865
Fier,Mallakaster,Hekal,790,561,110,84,3584,1461,1545,2039
Fier,Mallakaster,Kute,591,304,80,67,2401,975,1042,1359
Fier,Mallakaster,Ngracan,108,132,29,17,627,269,286,341
Fier,Mallakaster,Qender-Mallakaster,1167,1497,337,234,6523,3001,3235,3288
Fier,Mallakaster,Selite Mallakaster,219,185,51,24,1056,455,479,577
Fier,Patos,Patos,5209,3331,986,429,25246,9526,9955,15291
Fier,Patos,Ruzhdie,645,471,70,91,2435,1186,1277,1158
Fier,Patos,Zharres,1853,1309,265,195,6827,3427,3622,3205
Fier,Roskovec,Kuman,1481,1224,191,171,6607,2896,3067,3540
Fier,Roskovec,Kurjan,1161,642,162,81,4052,1965,2046,2006
Fier,Roskovec,Roskovec,1625,1327,170,136,7251,3122,3258,3993
Fier,Roskovec,Strum,2009,1751,174,132,7366,3934,4066,3300
Gjirokaster,Dropull,Dropull Poshte,802,295,285,93,8229,1382,1475,6754
Gjirokaster,Dropull,Dropull Siper,555,261,293,80,9046,1109,1189,7857
Gjirokaster,Dropull,Pogon,149,48,81,10,2685,278,288,2397
Gjirokaster,Gjirokaster,Antigone,385,198,92,21,1419,675,696,723
Gjirokaster,Gjirokaster,Cepo,796,581,222,52,3555,1599,1651,1904
Gjirokaster,Gjirokaster,Gjirokaster,7176,3401,1803,504,28130,12380,12884,15246
Gjirokaster,Gjirokaster,Lazarat,94,1599,137,46,2734,1830,1876,858
Gjirokaster,Gjirokaster,Lunxheri,779,362,202,44,4439,1343,1387,3052
Gjirokaster,Gjirokaster,Odrie,174,109,46,1,1398,329,330,1068
Gjirokaster,Gjirokaster,Picar,363,286,121,44,1519,770,814,705
Gjirokaster,Kelcyre,Ballaban,273,217,35,29,1501,525,554,947
Gjirokaster,Kelcyre,Dishnice,354,224,110,30,1842,688,718,1124
Gjirokaster,Kelcyre,Kelcyre,759,531,292,99,4096,1582,1681,2415
Gjirokaster,Kelcyre,Suke,437,131,166,35,1980,734,769,1211
Gjirokaster,Libohove,Libohove,580,603,114,82,2685,1297,1379,1306
Gjirokaster,Libohove,Qender-Libohove,453,233,146,48,2366,832,880,1486
Gjirokaster,Libohove,Zagori,123,65,26,12,813,214,226,587
Gjirokaster,Memaliaj,Buz,249,116,54,14,975,419,433,542
Gjirokaster,Memaliaj,F. Memaliaj,601,209,181,80,2117,991,1071,1046
Gjirokaster,Memaliaj,Krahes,569,211,349,103,2958,1129,1232,1726
Gjirokaster,Memaliaj,Luftinje,515,195,223,65,2531,933,998,1533
Gjirokaster,Memaliaj,Memaliaj,857,513,239,114,5365,1609,1723,3642
Gjirokaster,Memaliaj,Qesarat,480,160,142,35,1875,782,817,1058
Gjirokaster,Permet,Carcove,312,182,57,28,2321,551,579,1742
Gjirokaster,Permet,Frasher,110,62,14,19,465,186,205,260
Gjirokaster,Permet,Permet,2062,1053,406,212,8346,3521,3733,4613
Gjirokaster,Permet,Petran,501,427,80,44,2525,1008,1052,1473
Gjirokaster,Permet,Qender-Piskove,663,300,171,53,2548,1134,1187,1361
Gjirokaster,Tepelene,Kurvelesh,286,135,52,31,1074,473,504,570
Gjirokaster,Tepelene,Lopes,275,171,33,15,935,479,494,441
Gjirokaster,Tepelene,Qender-Tepelene,1155,368,425,108,4292,1948,2056,2236
Gjirokaster,Tepelene,Tepelene,1717,758,483,166,6506,2958,3124,3382
Korce,Devoll,Bilisht,2062,1961,507,169,8594,4530,4699,3895
Korce,Devoll,Hocisht,1228,1227,255,107,5429,2710,2817,2612
Korce,Devoll,Miras,1821,1734,295,153,7868,3850,4003,3865
Korce,Devoll,Proger,951,1229,191,101,4770,2371,2472,2298
Korce,Devoll,Qender-Bilisht,1363,1468,245,159,6980,3076,3235,3745
Korce,Kolonje,Barmash,150,92,35,12,546,277,289,257
Korce,Kolonje,Clirim,125,31,21,13,495,177,190,305
Korce,Kolonje,Erseke,1436,691,382,173,5473,2509,2682,2791
Korce,Kolonje,Leskovik,414,394,74,56,2258,882,938,1320
Korce,Kolonje,Mollas (KO),523,487,83,51,2638,1093,1144,1494
Korce,Kolonje,Novosele (KO),164,63,27,22,436,254,276,160
Korce,Kolonje,Qender-Erseke,776,496,277,115,3146,1549,1664,1482
Korce,Kolonje,Qender-Leskovik,78,45,12,9,339,135,144,195
Korce,Korce,Drenove,1498,1152,335,140,8918,2985,3125,5793
Korce,Korce,Lekas,145,49,38,20,667,232,252,415
Korce,Korce,Mollaj,1040,903,242,180,5702,2185,2365,3337
Korce,Korce,Qender-Bulgarec,2346,2528,386,273,11134,5260,5533,5601
Korce,Korce,Vithkuq,343,194,53,48,1270,590,638,632
Korce,Korce,Voskop,981,1118,175,113,4633,2274,2387,2246
Korce,Korce,Voskopoje,324,284,106,35,1857,714,749,1108
Korce,Korce,Korce,14160,12035,3207,1120,75079,29402,30522,44557
Korce,Maliq,Gore,445,437,56,35,1718,938,973,745
Korce,Maliq,Libonik,3010,1757,397,320,10908,5164,5484,5424
Korce,Maliq,Maliq,1685,833,219,164,6376,2737,2901,3475
Korce,Maliq,Moglice,344,132,21,33,1021,497,530,491
Korce,Maliq,Pirg,1925,1769,372,212,7652,4066,4278,3374
Korce,Maliq,Pojan,2744,2863,578,348,13438,6185,6533,6905
Korce,Maliq,Vreshtas,1896,1525,293,311,8150,3714,4025,4125
Korce,Pogradec,Bucimas,2832,3451,897,696,15168,7180,7876,7292
Korce,Pogradec,Cerrave,1636,1630,465,371,7462,3731,4102,3360
Korce,Pogradec,Dardhas,573,590,137,137,2678,1300,1437,1241
Korce,Pogradec,Porgradec,6745,4493,1331,863,32073,12569,13432,18641
Korce,Pogradec,Proptisht,1245,622,197,202,4484,2064,2266,2218
Korce,Pogradec,Trebinje,506,332,141,109,2355,979,1088,1267
Korce,Pogradec,Udenisht,1539,1125,352,297,5977,3016,3313,2664
Korce,Pogradec,Velcan,623,266,195,135,2305,1084,1219,1086
Korce,Pustec,Pustec,867,473,193,73,4366,1533,1606,2760
Kukes,Has,Fajze,489,842,15,83,3175,1346,1429,1746
Kukes,Has,Gjinaj,131,243,3,41,823,377,418,405
Kukes,Has,Golaj,956,1791,31,128,6004,2778,2906,3098
Kukes,Has,Krume,1095,1900,32,236,6126,3027,3263,2863
Kukes,Kukes,Arren,79,79,1,2,316,159,161,155
Kukes,Kukes,Bicaj,850,1423,44,113,4473,2317,2430,2043
Kukes,Kukes,Bushtrice,284,212,9,14,1046,505,519,527
Kukes,Kukes,Gryke Caje,123,300,18,21,1169,441,462,707
Kukes,Kukes,Kalis,130,159,5,11,626,294,305,321
Kukes,Kukes,Kolsh Kukes,154,365,15,32,1060,534,566,494
Kukes,Kukes,Kukes,3413,5777,235,533,18360,9425,9958,8402
Kukes,Kukes,Malzi,369,643,16,52,2584,1028,1080,1504
Kukes,Kukes,Shishtavec,818,629,10,51,3828,1457,1508,2320
Kukes,Kukes,Shtiqen,467,870,28,63,2752,1365,1428,1324
Kukes,Kukes,Surroj,173,375,23,37,1196,571,608,588
Kukes,Kukes,Terthore,379,812,16,50,2391,1207,1257,1134
Kukes,Kukes,Topojan,209,414,13,38,1607,636,674,933
Kukes,Kukes,Ujmisht,276,466,25,31,1593,767,798,795
Kukes,Kukes,Zapod,367,328,19,34,1880,714,748,1132
Kukes,Tropoje,Bajram Curri,1008,1873,59,181,6570,2940,3121,3449
Kukes,Tropoje,Bujan,269,674,17,60,2192,960,1020,1172
Kukes,Tropoje,Bytyc,177,469,10,47,1609,656,703,906
Kukes,Tropoje,Fierze (KU),305,553,13,58,1840,871,929,911
Kukes,Tropoje,Lekbibaj,171,297,11,39,1284,479,518,766
Kukes,Tropoje,Llugaj,306,447,8,69,1709,761,830,879
Kukes,Tropoje,Margegaj,334,716,16,67,2468,1066,1133,1335
Kukes,Tropoje,Tropoje,524,1414,37,97,4346,1975,2072,2274
Lezhe,Kurbin,Fushe Kuqe,699,1566,359,214,7051,2624,2838,4213
Lezhe,Kurbin,Lac,3486,4596,1303,756,23532,9385,10141,13391
Lezhe,Kurbin,Mamurras,2104,4165,1315,557,17870,7584,8141,9729
Lezhe,Kurbin,Milot,1103,2547,680,308,9166,4330,4638,4528
Lezhe,Lezhe,Balldre,1357,1411,444,240,8515,3212,3452,5063
Lezhe,Lezhe,Lezhe,4549,4074,1547,637,24906,10170,10807,14099
Lezhe,Lezhe,Shengjin,1987,1867,483,255,10468,4337,4592,5876
Lezhe,Lezhe,Blinisht,898,633,136,107,4465,1667,1774,2691
Lezhe,Lezhe,Dajc (LE),888,1042,172,160,5853,2102,2262,3591
Lezhe,Lezhe,Kallmet,758,773,500,146,5671,2031,2177,3494
Lezhe,Lezhe,Kolsh,1031,1137,282,222,5798,2450,2672,3126
Lezhe,Lezhe,Shenkoll,1980,2532,704,415,13167,5216,5631,7536
Lezhe,Lezhe,Ungrej,379,408,78,67,2063,865,932,1131
Lezhe,Lezhe,Zejmen,1172,1347,692,260,7406,3211,3471,3935
Lezhe,Mirdite,Fan,682,763,125,96,3193,1570,1666,1527
Lezhe,Mirdite,Kacinar,224,295,40,25,1331,559,584,747
Lezhe,Mirdite,Kthelle,379,501,182,55,2400,1062,1117,1283
Lezhe,Mirdite,Orosh,428,487,128,62,2355,1043,1105,1250
Lezhe,Mirdite,Rreshen,1956,2409,850,223,11190,5215,5438,5752
Lezhe,Mirdite,Rubik,1007,1145,355,112,6231,2507,2619,3612
Lezhe,Mirdite,Selite,202,298,62,29,1268,562,591,677
Shkoder,Fushe Arrez,Blerim,143,187,86,27,1010,416,443,567
Shkoder,Fushe Arrez,Fierze (ShK),196,164,258,32,1423,618,650,773
Shkoder,Fushe Arrez,Fushe Arrez,583,705,380,101,3534,1668,1769,1765
Shkoder,Fushe Arrez,Iballe,248,282,79,42,1266,609,651,615
Shkoder,Fushe Arrez,Qafe-Mali,209,294,178,56,1453,681,737,716
Shkoder,Malesi e Madhe,Gruemire,1744,1594,985,362,11706,4323,4685,7021
Shkoder,Malesi e Madhe,Kastrat,1405,1665,336,249,10185,3406,3655,6530
Shkoder,Malesi e Madhe,Kelmend,565,674,179,127,5149,1418,1545,3604
Shkoder,Malesi e Madhe,Koplik,1118,1128,390,200,7493,2636,2836,4657
Shkoder,Malesi e Madhe,Qender-Malesi e Madhe,869,1247,307,236,5685,2423,2659,3026
Shkoder,Malesi e Madhe,Shkrel,820,782,238,172,5049,1840,2012,3037
Shkoder,Puke,Gjegjan,800,479,196,106,2826,1475,1581,1245
Shkoder,Puke,Puke,900,868,381,100,4055,2149,2249,1806
Shkoder,Puke,Qelez,409,314,145,46,1686,868,914,772
Shkoder,Puke,Qerret,398,370,147,60,2079,915,975,1104
Shkoder,Puke,Rrape,313,183,97,38,1183,593,631,552
Shkoder,Shkoder,Ana Malit,470,770,722,88,4820,1962,2050,2770
Shkoder,Shkoder,Berdice,855,1362,924,149,7642,3141,3290,4352
Shkoder,Shkoder,Dajc (ShK),523,958,349,93,7261,1830,1923,5338
Shkoder,Shkoder,Gur I Zi,589,1650,1705,250,9119,3944,4194,4925
Shkoder,Shkoder,Postribe,915,1748,804,173,8772,3467,3640,5132
Shkoder,Shkoder,Pult,140,280,285,42,2098,705,747,1351
Shkoder,Shkoder,Rrethinat,1717,3292,2982,520,21022,7991,8511,12511
Shkoder,Shkoder,Shale,269,279,217,36,2916,765,801,2115
Shkoder,Shkoder,Shosh,91,120,93,12,839,304,316,523
Shkoder,Shkoder,Velipoje,1157,1014,784,166,7639,2955,3121,4518
Shkoder,Shkoder,Shkoder,9122,18420,11510,1705,94855,39052,40757,54098
Shkoder,Vau Dejes,Bushat,1456,2904,2665,396,19328,7025,7421,11907
Shkoder,Vau Dejes,Hajmel,631,995,640,113,5267,2266,2379,2888
Shkoder,Vau Dejes,Shllak,17,284,296,25,1381,597,622,759
Shkoder,Vau Dejes,Temal,117,302,353,49,1586,772,821,765
Shkoder,Vau Dejes,Vau Dejes,1424,1608,1257,312,10130,4289,4601,5529
Shkoder,Vau Dejes,Vig-Mnele,83,283,312,31,1621,678,709,912
Tirane,Kamez,Kamez,12681,16929,4033,1801,67992,33643,35444,32548
Tirane,Kamez,Paskuqan,6663,8835,2328,784,35437,17826,18610,16827
Tirane,Kavaje,Golem (TR),1969,1750,346,179,10416,4065,4244,6172
Tirane,Kavaje,Helmes,703,623,140,50,3939,1466,1516,2423
Tirane,Kavaje,Kavaje,5331,5685,1370,487,33126,12386,12873,20253
Tirane,Kavaje,Luz I Vogel,1099,955,95,105,8366,2149,2254,6112
Tirane,Kavaje,Synej,1236,1102,128,120,8882,2466,2586,6296
Tirane,Rrogozhine,Gose,1020,936,177,121,6732,2133,2254,4478
Tirane,Rrogozhine,Kryevidh,844,692,481,86,7127,2017,2103,5024
Tirane,Rrogozhine,Lekaj,1047,1024,204,138,7340,2275,2413,4927
Tirane,Rrogozhine,Rrogozhine,2115,1145,376,179,9508,3636,3815,5693
Tirane,Rrogozhine,Sinaballaj,311,152,54,22,1289,517,539,750
Tirane,Tirane,Baldushk,1226,1077,323,127,4131,2626,2753,1378
Tirane,Tirane,Kashar,12994,8747,3283,1118,40748,25024,26142,14606
Tirane,Tirane,Ndroq,2024,1290,403,272,7302,3717,3989,3313
Tirane,Tirane,Petrele,2079,1257,194,190,5222,3530,3720,1502
Tirane,Tirane,Peze,1739,901,260,235,4672,2900,3135,1537
Tirane,Tirane,Vaqarr,2551,1895,452,348,7791,4898,5246,2545
Tirane,Tirane,Berzhite,1793,799,264,172,4594,2856,3028,1566
Tirane,Tirane,Dajt,6131,4013,1980,544,19928,12124,12668,7260
Tirane,Tirane,Farke,6252,4439,1373,464,18277,12064,12528,5749
Tirane,Tirane,Krrabe,1020,304,83,80,2381,1407,1487,894
Tirane,Tirane,Shengjergj,634,543,137,76,1991,1314,1390,601
Tirane,Tirane,Zall Bastar,1328,928,342,133,3852,2598,2731,1121
Tirane,Tirane,Zall Herr,3249,1587,433,356,9039,5269,5625,3414
Tirane,Tirane,Njesia Nr. 1,11375,7537,2812,899,41790,21724,22623,19167
Tirane,Tirane,Njesia Nr. 2,17380,14319,4539,1091,67552,36238,37329,30223
Tirane,Tirane,Njesia Nr. 3,9089,6827,2775,648,37427,18691,19339,18088
Tirane,Tirane,Njesia Nr. 4,12627,9542,3371,1068,52562,25540,26608,25954
Tirane,Tirane,Njesia Nr. 5,20230,13225,5467,1036,71200,38922,39958,31242
Tirane,Tirane,Njesia Nr. 6,15596,9994,3482,1256,56854,29072,30328,26526
Tirane,Tirane,Njesia Nr. 7,15918,12661,4029,982,61709,32608,33590,28119
Tirane,Tirane,Njesia Nr. 8,7558,7921,2154,380,34033,17633,18013,16020
Tirane,Tirane,Njesia Nr. 9,13131,11590,3134,919,52717,27855,28774,23943
Tirane,Tirane,Njesia Nr. 10,6007,4550,1419,120,23597,11976,12096,11501
Tirane,Tirane,Njesia Nr. 11,11434,10856,2904,1045,50918,25194,26239,24679
Tirane,Vore,Berxull,1750,2292,622,218,8569,4664,4882,3687
Tirane,Vore,Preze,1683,927,158,140,5396,2768,2908,2488
Tirane,Vore,Vore,5025,2486,764,433,16088,8275,8708,7380
Vlore,Delvine,Delvine,1998,1347,529,246,11881,3874,4120,7761
Vlore,Delvine,Vergo,601,347,137,74,2963,1085,1159,1804
Vlore,Finiq,Aliko,251,291,45,30,5108,587,617,4491
Vlore,Finiq,Dhiver,416,158,51,53,5554,625,678,4876
Vlore,Finiq,Finiq,423,213,103,48,5426,739,787,4639
Vlore,Finiq,Livadhja,673,464,86,97,9046,1223,1320,7726
Vlore,Finiq,Mesopotam,445,296,60,50,5742,801,851,4891
Vlore,Himare,Himare,1360,983,162,29,12042,2505,2534,9508
Vlore,Himare,Hore Vranisht,1051,150,97,35,2811,1298,1333,1478
Vlore,Himare,Lukove,1036,721,198,60,7977,1955,2015,5962
Vlore,Konispol,Konsipol,861,494,54,87,2459,1409,1496,963
Vlore,Konispol,Markat,661,438,28,75,2435,1127,1202,1233
Vlore,Konispol,Xarre,712,422,251,111,6447,1385,1496,4951
Vlore,Sarande,Ksamil,1236,779,296,122,7243,2311,2433,4810
Vlore,Sarande,Sarande,6603,4281,1735,646,39846,12619,13265,26581
Vlore,Selenice,Armen,1105,522,179,112,5228,1806,1918,3310
Vlore,Selenice,Brataj,922,417,157,91,3572,1496,1587,1985
Vlore,Selenice,Kote,1316,634,136,72,5052,2086,2158,2894
Vlore,Selenice,Selenice,845,455,96,82,5463,1396,1478,3985
Vlore,Selenice,Sevaster,456,345,90,55,2258,891,946,1312
Vlore,Selenice,Vllahine,1284,720,133,105,5283,2137,2242,3041
Vlore,Vlore,Novosele (VL),2512,1241,344,249,13461,4097,4346,9115
Vlore,Vlore,Orikum,1879,920,479,170,9333,3278,3448,5885
Vlore,Vlore,Qender-Vlore,2473,1354,428,231,15191,4255,4486,10705
Vlore,Vlore,Shushice,1470,586,235,124,7561,2291,2415,5146
Vlore,Vlore,Vlore,26434,13550,4663,1676,119046,44647,46323,72723
